NO         MAPS/turbolol.xpm
SO          MAPS/mc.xpm
WE           MAPS/mur_bleu.xpm
EA         MAPS/shamizi.xpm
C             20,50,128
F     150,            100,100



        1111111111111111111111111
        1000000000110000000000001
        1011000001110000000000001
        1001000000000000000000001  11111
111111111011000001110000000000001  10001 11111
100000000011000001110111110111111  10101110001
11110111111111011100000010001      10111010001
11110111111111011101010010001      10000011011
11000000110101011100000010001      10111110001
1000000000000001100000010N01       10000000101
1000000000000000110101001001111111111110111101111
1100000111010101111101111000000000000000100000001
11110111 1110101 10101101000111111111111101000101
11111111 1110111 111011111111           100000001
           101     101                  101000101
           10111111101                  100000001
           10000000001                  101000101
           11111000001                  100000001
               1111111                  111111111
