NO MAPS/leu.xpm
SO MAPS/leu.xpm
WE MAPS/mur_une.xpm
EA MAPS/mur_jaune.xpm
C 128,200,255
F 64, 200, 64

1111111
1000001
1000001
100N001
1000001
1000001
1111111
