NO MAPS/leu.xpm
SO MAPS/leu.xpm
WE MAPS/mur_une.xpm
EA MAPS/mur_jaune.xpm
C 128,255,255
F 64, 255, 64

1111111
1000001
1010101
100N001
1010101
1000001
1111111
