NO         MAPS/texture/turbolol.xpm
SO          MAPS/texture/mc.xpm
WE           MAPS/texture/mur_bleu.xpm
EA         MAPS/texture/shamizi.xpm
C             20,50,128
F     150,            100,100


1111111111111111111111111111111
1000000000000000000E11111111111
1000000000111111111111111111111111111111
1000011111
011111111111111111101
1111111111111111111111111000000
