
C             255,23,20
NO         ./path_to_the_north_texture
SO          ./path_to_the_south_texture
WE           ./path_to_the_west_texture
EA         ./path_to_the_east_texture
F     150,            100,100


111111111111111111111111
100000000000000000000001
110000000000000000000001
100000000000N00000000001
000000000000000000000001
100000000000000000000001
111111111111111111111111
