NO         MAPS/turbolol.xpm
SO          MAPS/mc.xpm
WE           MAPS/mur_bleu.xpm
EA         MAPS/shamizi.xpm
C             0,64,128
F     150,            100,100



        1111111111111111111111111
        1000000000110000000000001
        1011000001110000000000001
        1001000000000000000000001
111111111011000001110000000000001
100000000011000001110111110111111
11110111111111011100000010001
11110111111111011101010010001
11000000110101011100000010001
1000000000000001100000010S01
1000000000000000110101001001
1100000111010101111101111000100001
11110111 1110101 101111010001
11111111 1111111 111111111111
