NO truc
SO truc
WE truc
EA truc
C 128,255,255
F 64, 255, 64

111111111111
1000001
1010101
100N001
1010101
1000001
11111111111
