
C             255,23,20
NO         MAPS/shamizi.xpm
SO          MAPS/mur_bleu.xpm
WE           MAPS/turbolol.xpm
EA         MAPS/bn.xpm
F     150,            100,100


111111111111111111111111
100000000000000000000001
110000000000000000000001
100000000000N00000000001
100000000000000000000001
100000000000000000000001
111111111111111111111111
